
 *   ******
   *      *
 * * ***  *
 * *  **  /
*  *   *  *
/*****  * *
 * *   *  *
     * ****
* ** *   **
* *  * *  /
*/*********
