 *   * * *
 * *     *
 * * * * *
 * * * * *
   *     *
 * * * * *
   * * * *
**** * / *