	*				*	*	*
	*		*				
	*		*		*	*	*
	*		*	*	*	*	*
			*				*
*	*		*		*		
	*		*		*		*
					*	/	*